3 3 3 3 3 3 3 3 3 3 3 3 3 3 3 3 3 3
3 2 2 2 1 2 2 1 2 2 2 2 2 2 2 2 2 3
3 4 0 0 0 0 0 0 0 1 2 2 2 2 2 2 2 3
3 2 2 1 2 2 1 2 0 2 2 2 2 2 2 2 2 3
3 2 2 2 2 2 2 2 0 2 2 2 2 2 2 2 2 3
3 2 2 2 2 2 2 1 0 0 0 0 1 2 2 2 2 3
3 2 2 2 2 2 2 2 2 1 2 0 2 1 2 2 1 3
3 2 2 2 2 2 2 2 2 2 1 0 0 0 0 0 5 3
3 3 3 3 3 3 3 3 3 3 3 3 3 3 3 3 3 3